,Customer ID,frequency,monetary,recency,r_score,f_score,m_score,rfm_sum,rfm_label
0,AA-10315,11,5563.56,1865,2,3,5,10,em risco
1,AA-10375,15,1056.39,1700,5,4,2,11,campeões
2,AA-10480,12,1790.5120000000002,1940,1,3,3,7,em risco
3,AA-10645,18,5086.9349999999995,1736,3,4,5,12,clientes leais
4,AB-10015,6,886.156,2096,1,1,1,3,dormentes
5,AB-10060,18,7755.62,1735,3,4,5,12,clientes leais
6,AB-10105,20,14473.570999999998,1722,4,5,5,14,clientes leais
7,AB-10150,12,966.71,1722,4,3,2,9,potenciais leais
8,AB-10165,14,1113.838,1706,5,4,2,11,campeões
9,AB-10255,14,914.5319999999999,1847,2,4,1,7,em risco
10,AB-10600,8,1515.862,1731,4,2,2,8,potenciais leais
11,AC-10420,5,925.8,1913,1,1,1,3,dormentes
12,AC-10450,9,5527.846,1692,5,2,5,12,potenciais leais
13,AC-10615,18,2537.6859999999997,1687,5,4,3,12,campeões
14,AC-10660,6,657.316,1963,1,1,1,3,dormentes
15,AD-10180,12,6106.88,1710,4,3,5,12,potenciais leais
16,AF-10870,16,2052.908,1722,4,4,3,11,clientes leais
17,AF-10885,7,861.565,2096,1,1,1,3,dormentes
18,AG-10270,14,2582.898,1959,1,4,3,8,em risco
19,AG-10300,5,367.548,1799,2,1,1,4,dormentes
20,AG-10330,9,660.972,1689,5,2,1,8,potenciais leais
21,AG-10390,8,200.945,1795,2,2,1,5,dormentes
22,AG-10495,21,2356.855,1759,3,5,3,11,clientes leais
23,AG-10525,9,1455.038,2526,1,2,2,5,dormentes
24,AG-10675,15,3489.0396000000005,1778,3,4,4,11,clientes leais
25,AG-10765,5,170.584,1758,3,1,1,5,quase dormentes
26,AG-10900,21,4510.797,1777,3,5,5,13,clientes leais
27,AH-10030,11,1744.7,1693,5,3,3,11,potenciais leais
28,AH-10075,20,3250.337,1715,4,5,4,13,clientes leais
29,AH-10120,16,1735.5140000000001,1741,3,4,2,9,clientes leais
30,AH-10195,8,1587.452,1736,3,2,2,7,quase dormentes
31,AH-10210,13,4805.344,1687,5,3,5,13,potenciais leais
32,AH-10465,8,2495.3916,1911,1,2,3,6,dormentes
33,AH-10585,5,738.504,1702,5,1,1,7,novos clientes
34,AH-10690,23,7888.294,2091,1,5,5,11,não podemos perdê-los
35,AI-10855,18,4375.786,1694,5,4,5,14,campeões
36,AJ-10780,15,4867.344,1756,3,4,5,12,clientes leais
37,AJ-10795,21,4501.391,1847,2,5,5,12,não podemos perdê-los
38,AJ-10945,10,1839.24,1766,3,2,3,8,quase dormentes
39,AJ-10960,5,629.2479999999999,1755,3,1,1,5,quase dormentes
40,AM-10360,12,814.012,1709,4,3,1,8,potenciais leais
41,AM-10705,22,5664.022,1843,2,5,5,12,não podemos perdê-los
42,AO-10810,1,161.28,2182,1,1,1,3,dormentes
43,AP-10720,19,1638.554,1722,4,5,2,11,clientes leais
44,AP-10915,31,3323.556,1779,3,5,4,12,clientes leais
45,AR-10345,5,1055.694,1792,2,1,2,5,dormentes
46,AR-10405,7,2236.128,1806,2,1,3,6,dormentes
47,AR-10510,7,264.86400000000003,1695,5,1,1,7,novos clientes
48,AR-10540,9,6608.448,1687,5,2,5,12,potenciais leais
49,AR-10570,2,88.15,2215,1,1,1,3,dormentes
50,AR-10825,13,4523.336,1739,3,3,5,11,precisam de atenção
51,AS-10045,10,3050.692,1769,3,2,4,9,quase dormentes
52,AS-10090,25,3255.31,1709,4,5,4,13,clientes leais
53,AS-10135,3,58.82,1722,4,1,1,6,promissores
54,AS-10225,13,4260.784,1703,5,3,4,12,potenciais leais
55,AS-10240,13,584.6080000000001,1873,2,3,1,6,em risco
56,AS-10285,8,3214.236,1700,5,2,4,11,potenciais leais
57,AS-10630,12,833.398,1773,3,3,1,7,precisam de atenção
58,AT-10435,9,1171.814,1702,5,2,2,9,potenciais leais
59,AT-10735,16,3831.864,1694,5,4,4,13,campeões
60,AW-10840,8,649.376,1701,5,2,1,8,potenciais leais
61,AW-10930,16,2852.968,1727,4,4,4,12,clientes leais
62,AY-10555,10,497.014,1695,5,2,1,8,potenciais leais
63,AZ-10750,12,1622.0179999999998,1841,2,3,2,7,em risco
64,BB-10990,8,744.3399999999999,1786,2,2,1,5,dormentes
65,BB-11545,20,6765.728,1709,4,5,5,14,clientes leais
66,BC-11125,18,2933.676,1883,2,4,4,10,em risco
67,BD-11320,19,5718.521,1714,4,5,5,14,clientes leais
68,BD-11500,10,4411.2429999999995,1716,4,2,5,11,potenciais leais
69,BD-11560,4,320.54,1959,1,1,1,3,dormentes
70,BD-11605,20,3288.471,1778,3,5,4,12,clientes leais
71,BD-11620,8,1538.11,1750,3,2,2,7,quase dormentes
72,BD-11635,5,582.646,1690,5,1,1,7,novos clientes
73,BD-11725,10,1526.5,1774,3,2,2,7,quase dormentes
74,BD-11770,10,658.466,2008,1,2,1,4,dormentes
75,BE-11335,9,4204.676,1800,2,2,4,8,dormentes
76,BE-11410,5,2261.438,1779,3,1,3,7,quase dormentes
77,BE-11455,13,1727.652,1935,1,3,2,6,em risco
78,BF-10975,13,599.798,1772,3,3,1,7,precisam de atenção
79,BF-11005,10,1333.88,1720,4,2,2,8,potenciais leais
80,BF-11020,21,2888.506,1755,3,5,4,12,clientes leais
81,BF-11080,6,272.95,1706,5,1,1,7,novos clientes
82,BF-11170,27,5907.972,1697,5,5,5,15,campeões
83,BF-11215,8,1585.162,1746,3,2,2,7,quase dormentes
84,BF-11275,4,791.9899999999999,1738,3,1,1,5,quase dormentes
85,BG-11035,12,2798.948,1709,4,3,4,11,potenciais leais
86,BG-11695,8,1874.172,1717,4,2,3,9,potenciais leais
87,BG-11740,7,1006.356,1738,3,1,2,6,quase dormentes
88,BH-11710,24,6255.351,1704,5,5,5,15,campeões
89,BK-11260,16,659.1379999999999,1758,3,4,1,8,clientes leais
90,BM-11140,16,11789.63,1988,1,4,5,10,em risco
91,BM-11575,10,808.162,1781,3,2,1,6,quase dormentes
92,BM-11650,29,7294.185,1714,4,5,5,14,clientes leais
93,BM-11785,14,1338.842,1899,2,4,2,8,em risco
94,BN-11470,6,265.296,1705,5,1,1,7,novos clientes
95,BN-11515,17,1459.344,1690,5,4,2,11,campeões
96,BO-11350,12,2682.728,1818,2,3,3,8,em risco
97,BO-11425,2,130.83,1756,3,1,1,5,quase dormentes
98,BP-11050,7,983.42,1764,3,1,2,6,quase dormentes
99,BP-11095,20,2442.044,1698,5,5,3,13,campeões
100,BP-11155,11,1697.8609999999999,1770,3,3,2,8,precisam de atenção
101,BP-11185,18,3675.861,1682,5,4,4,13,campeões
102,BP-11230,6,1181.49,1720,4,1,2,7,promissores
103,BP-11290,16,2475.157,1693,5,4,3,12,campeões
104,BS-11365,9,10501.653,2239,1,2,5,8,dormentes
105,BS-11380,13,3887.834,1709,4,3,4,11,potenciais leais
106,BS-11590,10,2454.928,1716,4,2,3,9,potenciais leais
107,BS-11665,11,3288.1099999999997,2263,1,3,4,8,em risco
108,BS-11755,14,2562.382,1682,5,4,3,12,campeões
109,BS-11800,8,949.4300000000001,1946,1,2,1,4,dormentes
110,BT-11305,9,2567.656,2017,1,2,3,6,dormentes
111,BT-11395,10,2186.6130000000003,1983,1,2,3,6,dormentes
112,BT-11440,7,603.876,2241,1,1,1,3,dormentes
113,BT-11485,3,415.19599999999997,2340,1,1,1,3,dormentes
114,BT-11530,10,2684.4919999999997,1772,3,2,3,8,quase dormentes
115,BT-11680,20,3196.752,1701,5,5,4,14,campeões
116,BV-11245,14,1523.2730000000001,2015,1,4,2,7,em risco
117,BW-11065,3,385.516,1893,2,1,1,4,dormentes
118,BW-11110,17,4750.358,1802,2,4,5,11,em risco
119,BW-11200,10,1738.406,1884,2,2,2,6,dormentes
120,CA-11965,10,3789.7228,1777,3,2,4,9,quase dormentes
121,CA-12055,10,1679.7240000000002,2082,1,2,2,5,dormentes
122,CA-12265,17,2648.2872,1737,3,4,3,10,clientes leais
123,CA-12310,11,1421.954,1694,5,3,2,10,potenciais leais
124,CA-12775,17,3041.566,1801,2,4,4,10,em risco
125,CB-12025,26,6076.139,1728,4,5,5,14,clientes leais
126,CB-12415,12,1949.2,1707,5,3,3,11,potenciais leais
127,CB-12535,19,4246.4555,1878,2,5,4,11,não podemos perdê-los
128,CC-12100,13,1770.945,2138,1,3,3,7,em risco
129,CC-12145,11,2471.65,1787,2,3,3,8,em risco
130,CC-12220,22,3913.418,1701,5,5,4,14,campeões
131,CC-12370,11,12129.072000000002,1724,4,3,5,12,potenciais leais
132,CC-12430,19,2870.05,1681,5,5,4,14,campeões
133,CC-12475,13,1659.438,1720,4,3,2,9,potenciais leais
134,CC-12550,4,113.832,1708,4,1,1,6,promissores
135,CC-12610,12,2540.631,1715,4,3,3,10,potenciais leais
136,CC-12670,14,2269.7015,1710,4,4,3,11,clientes leais
137,CC-12685,12,2854.1150000000002,2480,1,3,4,8,em risco
138,CD-11920,9,2033.968,1721,4,2,3,9,potenciais leais
139,CD-11980,6,639.766,1735,3,1,1,5,quase dormentes
140,CD-12280,13,1205.584,1723,4,3,2,9,potenciais leais
141,CD-12790,15,1860.732,2080,1,4,3,8,em risco
142,CG-12040,9,904.4680000000001,1730,4,2,1,7,potenciais leais
143,CG-12520,5,1148.7800000000002,2019,1,1,2,4,dormentes
144,CH-12070,4,1537.236,2372,1,1,2,4,dormentes
145,CJ-11875,1,16.52,2046,1,1,1,3,dormentes
146,CJ-12010,20,11164.974,1870,2,5,5,12,não podemos perdê-los
147,CK-12205,32,3154.855,1720,4,5,4,13,clientes leais
148,CK-12325,12,2945.321,1801,2,3,4,9,em risco
149,CK-12595,25,2372.75,1724,4,5,3,12,clientes leais
150,CK-12760,14,1582.109,1763,3,4,2,9,clientes leais
151,CL-11890,7,1262.0140000000001,1787,2,1,2,5,dormentes
152,CL-12565,28,10880.546,1965,1,5,5,11,não podemos perdê-los
153,CL-12700,8,2353.586,1786,2,2,3,7,dormentes
154,CM-11815,10,1673.888,1812,2,2,2,6,dormentes
155,CM-11935,4,565.392,2389,1,1,1,3,dormentes
156,CM-12115,7,1661.6100000000001,1689,5,1,2,8,novos clientes
157,CM-12160,7,2533.314,1707,5,1,3,9,novos clientes
158,CM-12190,7,1475.144,1689,5,1,2,8,novos clientes
159,CM-12235,8,2305.712,2066,1,2,3,6,dormentes
160,CM-12385,10,8954.019999999999,1718,4,2,5,11,potenciais leais
161,CM-12445,9,287.99,2117,1,2,1,4,dormentes
162,CM-12655,10,6339.5576,1708,4,2,5,11,potenciais leais
163,CM-12715,13,3984.4524,2716,1,3,4,8,em risco
164,CP-12085,14,5402.254,1763,3,4,5,12,clientes leais
165,CP-12340,15,5888.275,1841,2,4,5,11,em risco
166,CR-12580,6,2148.852,1738,3,1,3,7,quase dormentes
167,CR-12625,4,475.9,2151,1,1,1,3,dormentes
168,CR-12730,6,1600.55,1759,3,1,2,6,quase dormentes
169,CR-12820,7,1397.8724,1766,3,1,2,6,quase dormentes
170,CS-11845,8,1278.954,1772,3,2,2,7,quase dormentes
171,CS-11860,7,537.632,1843,2,1,1,4,dormentes
172,CS-11950,22,3036.547,1706,5,5,4,14,campeões
173,CS-12130,7,884.64,2170,1,1,1,3,dormentes
174,CS-12175,8,844.4580000000001,1913,1,2,1,4,dormentes
175,CS-12250,28,2754.216,1707,5,5,4,14,campeões
176,CS-12355,22,3202.1620000000003,1687,5,5,4,14,campeões
177,CS-12400,14,3651.8585000000003,1683,5,4,4,13,campeões
178,CS-12460,6,550.644,1708,4,1,1,6,promissores
179,CS-12490,9,1077.2285,2105,1,2,2,5,dormentes
180,CS-12505,9,5690.054999999999,1739,3,2,5,10,quase dormentes
181,CT-11995,18,3241.898,1777,3,4,4,11,clientes leais
182,CV-12295,13,2830.6279999999997,1935,1,3,4,8,em risco
183,CV-12805,19,2370.3136,1686,5,5,3,13,campeões
184,CW-11905,11,1136.592,1703,5,3,2,10,potenciais leais
185,CY-12745,11,2900.026,1741,3,3,4,10,precisam de atenção
186,Co-12640,8,1300.076,2230,1,2,2,5,dormentes
187,DA-13450,8,156.76,2033,1,2,1,4,dormentes
188,DB-12910,12,2171.599,1702,5,3,3,11,potenciais leais
189,DB-12970,14,2839.2272,1922,1,4,4,9,em risco
190,DB-13060,13,4531.646,1697,5,3,5,13,potenciais leais
191,DB-13120,14,2973.094,1729,4,4,4,12,clientes leais
192,DB-13210,21,2332.577,1690,5,5,3,13,campeões
193,DB-13270,13,4655.897,1734,4,3,5,12,potenciais leais
194,DB-13360,6,1081.466,1945,1,1,2,4,dormentes
195,DB-13405,14,1711.692,1868,2,4,2,8,em risco
196,DB-13555,14,3908.8028,1788,2,4,4,10,em risco
197,DB-13615,11,1989.05,1714,4,3,3,10,potenciais leais
198,DB-13660,10,1155.202,1693,5,2,2,9,potenciais leais
199,DC-12850,18,3336.168,1718,4,4,4,12,clientes leais
200,DC-13285,7,1174.618,1704,5,1,2,8,novos clientes
201,DD-13570,9,269.542,1722,4,2,1,7,potenciais leais
202,DE-13255,9,2550.874,2400,1,2,3,6,dormentes
203,DF-13135,6,2390.534,2381,1,1,3,5,dormentes
204,DG-13300,8,3195.818,1713,4,2,4,10,potenciais leais
205,DH-13075,23,4932.872,1958,1,5,5,11,não podemos perdê-los
206,DH-13675,11,1043.096,2457,1,3,2,6,em risco
207,DJ-13420,5,2012.52,2318,1,1,3,5,dormentes
208,DJ-13510,13,2501.6879999999996,1729,4,3,3,10,potenciais leais
209,DJ-13630,8,3356.398,1693,5,2,4,11,potenciais leais
210,DK-12835,27,3256.48,1702,5,5,4,14,campeões
211,DK-12895,15,4282.176,1726,4,4,4,12,clientes leais
212,DK-12985,8,1687.04,1688,5,2,2,9,potenciais leais
213,DK-13090,13,2650.557,1723,4,3,3,10,potenciais leais
214,DK-13150,5,797.832,1691,5,1,1,7,novos clientes
215,DK-13225,19,4802.394,1691,5,5,5,15,campeões
216,DK-13375,23,3318.486,1700,5,5,4,14,campeões
217,DL-12865,14,1503.112,1781,3,4,2,9,clientes leais
218,DL-12925,14,3272.2,1738,3,4,4,11,clientes leais
219,DL-13315,17,1458.258,1703,5,4,2,11,campeões
220,DL-13330,8,585.02,1738,3,2,1,6,quase dormentes
221,DL-13495,12,3539.322,1757,3,3,4,10,precisam de atenção
222,DM-12955,9,1322.034,1795,2,2,2,6,dormentes
223,DM-13015,20,6345.103,1738,3,5,5,13,clientes leais
224,DM-13345,13,4074.4719999999998,1703,5,3,4,12,potenciais leais
225,DM-13525,10,1376.792,2162,1,2,2,5,dormentes
226,DN-13690,11,2139.79,1898,2,3,3,8,em risco
227,DO-13435,13,1300.0315,1814,2,3,2,7,em risco
228,DO-13645,11,1267.316,1707,5,3,2,10,potenciais leais
229,DP-13000,17,1050.636,1807,2,4,2,8,em risco
230,DP-13105,14,2215.002,1687,5,4,3,12,campeões
231,DP-13165,4,1058.616,2493,1,1,2,4,dormentes
232,DP-13390,14,5480.723999999999,2039,1,4,5,10,em risco
233,DR-12880,24,6528.034000000001,1684,5,5,5,15,campeões
234,DR-12940,13,8350.868,1731,4,3,5,12,potenciais leais
235,DS-13030,19,1762.213,1774,3,5,3,11,clientes leais
236,DS-13180,20,2881.8128,1704,5,5,4,14,campeões
237,DV-13045,9,1119.483,1700,5,2,2,9,potenciais leais
238,DV-13465,15,3341.587,1710,4,4,4,12,clientes leais
239,DW-13195,9,1080.751,1750,3,2,2,7,quase dormentes
240,DW-13480,11,5271.628,1898,2,3,5,10,em risco
241,DW-13540,9,344.08,1779,3,2,1,6,quase dormentes
242,DW-13585,10,1204.854,1923,1,2,2,5,dormentes
243,Dl-13600,6,755.602,1800,2,1,1,4,dormentes
244,Dp-13240,29,7198.7609999999995,1765,3,5,5,13,clientes leais
245,EA-14035,25,2846.705,1833,2,5,4,11,não podemos perdê-los
246,EB-13705,12,3644.978,1729,4,3,4,11,potenciais leais
247,EB-13750,20,3236.314,1716,4,5,4,13,clientes leais
248,EB-13840,8,4358.128,1771,3,2,5,10,quase dormentes
249,EB-13870,11,2767.219,1781,3,3,4,10,precisam de atenção
250,EB-13930,7,944.6000000000001,1842,2,1,1,4,dormentes
251,EB-13975,6,1643.255,1681,5,1,2,8,novos clientes
252,EB-14110,11,3071.126,1794,2,3,4,9,em risco
253,EB-14170,7,1186.326,1763,3,1,2,6,quase dormentes
254,EC-14050,7,461.914,1734,4,1,1,6,promissores
255,ED-13885,14,3484.92,1816,2,4,4,10,em risco
256,EG-13900,9,1832.02,1703,5,2,3,10,potenciais leais
257,EH-13765,32,10310.880000000001,1816,2,5,5,12,não podemos perdê-los
258,EH-13945,17,684.1709999999999,1898,2,4,1,7,em risco
259,EH-13990,8,825.9499999999999,2086,1,2,1,4,dormentes
260,EH-14005,11,1219.53,1683,5,3,2,10,potenciais leais
261,EH-14125,18,3082.653,1833,2,4,4,10,em risco
262,EH-14185,8,923.884,1786,2,2,1,5,dormentes
263,EJ-13720,8,2162.174,1983,1,2,3,6,dormentes
264,EJ-14155,8,2656.691,1738,3,2,3,8,quase dormentes
265,EK-13795,4,1303.478,1725,4,1,2,7,promissores
266,EL-13735,2,124.28,1758,3,1,1,5,quase dormentes
267,EM-13810,7,2567.0099999999998,1813,2,1,3,6,dormentes
268,EM-13825,16,2339.598,1736,3,4,3,10,clientes leais
269,EM-13960,6,933.704,1832,2,1,1,4,dormentes
270,EM-14065,6,228.99,1728,4,1,1,6,promissores
271,EM-14095,10,1041.0420000000001,1794,2,2,2,6,dormentes
272,EM-14140,21,4588.436000000001,1729,4,5,5,14,clientes leais
273,EM-14200,4,366.822,1839,2,1,1,4,dormentes
274,EN-13780,9,2199.366,1968,1,2,3,6,dormentes
275,EP-13915,31,5478.0608,1693,5,5,5,15,campeões
276,ER-13855,5,1245.788,2102,1,1,2,4,dormentes
277,ES-14020,8,3510.4579999999996,1721,4,2,4,10,potenciais leais
278,ES-14080,20,4657.924,1709,4,5,5,14,clientes leais
279,FA-14230,17,2984.054,1778,3,4,4,11,clientes leais
280,FC-14245,14,3418.742,1751,3,4,4,11,clientes leais
281,FC-14335,10,3889.366,1865,2,2,4,8,dormentes
282,FG-14260,11,1383.144,1715,4,3,2,9,potenciais leais
283,FH-14275,21,4256.272,1718,4,5,4,13,clientes leais
284,FH-14350,14,2271.284,1893,2,4,3,9,em risco
285,FH-14365,13,6987.196,1686,5,3,5,13,potenciais leais
286,FM-14215,15,2456.638,1688,5,4,3,12,campeões
287,FM-14290,20,3736.198,1717,4,5,4,13,clientes leais
288,FM-14380,14,2523.266,1826,2,4,3,9,em risco
289,FO-14305,15,2678.438,1719,4,4,3,11,clientes leais
290,FP-14320,14,4046.746,1704,5,4,4,13,campeões
291,FW-14395,3,79.75,2043,1,1,1,3,dormentes
292,GA-14515,14,3919.7760000000003,1830,2,4,4,10,em risco
293,GA-14725,22,1398.382,1686,5,5,2,12,campeões
294,GB-14530,20,1568.44,1743,3,5,2,10,clientes leais
295,GB-14575,16,4716.288,1694,5,4,5,14,campeões
296,GD-14590,6,1888.07,1686,5,1,3,9,novos clientes
297,GG-14650,24,2224.0,1724,4,5,3,12,clientes leais
298,GH-14410,17,2819.4669999999996,1756,3,4,4,11,clientes leais
299,GH-14425,10,4172.8460000000005,1731,4,2,4,10,potenciais leais
300,GH-14485,3,1361.2440000000001,2068,1,1,2,4,dormentes
301,GH-14665,3,146.94080000000002,1683,5,1,1,7,novos clientes
302,GK-14620,14,6497.27,1793,2,4,5,11,em risco
303,GM-14440,11,3582.8199999999997,1764,3,3,4,10,precisam de atenção
304,GM-14455,12,3078.624,1697,5,3,4,12,potenciais leais
305,GM-14500,13,1255.682,1787,2,3,2,7,em risco
306,GM-14680,11,3163.628,1833,2,3,4,9,em risco
307,GM-14695,11,6049.966,1798,2,3,5,10,em risco
308,GP-14740,5,236.53,2446,1,1,1,3,dormentes
309,GR-14560,5,1284.38,2816,1,1,2,4,dormentes
310,GT-14635,6,9351.212,1737,3,1,5,9,quase dormentes
311,GT-14710,29,11820.119999999999,1717,4,5,5,14,clientes leais
312,GT-14755,7,226.436,1715,4,1,1,6,promissores
313,GW-14605,9,2189.019,1709,4,2,3,9,potenciais leais
314,GZ-14470,14,4355.150000000001,1688,5,4,5,14,campeões
315,GZ-14545,5,2454.6220000000003,1838,2,1,3,6,dormentes
316,HA-14905,10,2163.3,1750,3,2,3,8,quase dormentes
317,HA-14920,18,2584.158,1701,5,4,3,12,campeões
318,HD-14785,7,251.36,2450,1,1,1,3,dormentes
319,HE-14800,11,883.5319999999999,1693,5,3,1,9,potenciais leais
320,HF-14995,19,2533.1639999999998,1702,5,5,3,13,campeões
321,HG-14845,10,785.628,1735,3,2,1,6,quase dormentes
322,HG-14965,17,3247.642,1704,5,4,4,13,campeões
323,HG-15025,11,3690.284,1687,5,3,4,12,potenciais leais
324,HH-15010,6,218.668,1753,3,1,1,5,quase dormentes
325,HJ-14875,6,358.1,1807,2,1,1,4,dormentes
326,HK-14890,15,4877.784,1832,2,4,5,11,em risco
327,HL-15040,11,12873.297999999999,1724,4,3,5,12,potenciais leais
328,HM-14860,20,8236.7648,1683,5,5,5,15,campeões
329,HM-14980,7,736.276,1928,1,1,1,3,dormentes
330,HP-14815,10,1990.314,1711,4,2,3,9,potenciais leais
331,HR-14770,13,1299.288,1694,5,3,2,10,potenciais leais
332,HR-14830,14,5248.787,1840,2,4,5,11,em risco
333,HW-14935,20,9300.254,1798,2,5,5,12,não podemos perdê-los
334,HZ-14950,6,886.52,1716,4,1,1,6,promissores
335,IG-15085,7,744.574,1752,3,1,1,5,quase dormentes
336,IL-15100,14,5040.736,1823,2,4,5,11,em risco
337,IM-15055,4,2872.63,2090,1,1,4,6,dormentes
338,IM-15070,21,4930.474,2071,1,5,5,11,não podemos perdê-los
339,JA-15970,24,6491.026,1773,3,5,5,13,clientes leais
340,JB-15400,16,1791.605,1688,5,4,3,12,campeões
341,JB-15925,8,900.552,2418,1,2,1,4,dormentes
342,JB-16000,7,644.1188,1724,4,1,1,6,promissores
343,JB-16045,9,2518.115,1688,5,2,3,10,potenciais leais
344,JC-15340,4,71.263,1795,2,1,1,4,dormentes
345,JC-15385,4,1058.108,1856,2,1,2,5,dormentes
346,JC-15775,16,2772.055,1839,2,4,4,10,em risco
347,JC-16105,9,858.576,1738,3,2,1,6,quase dormentes
348,JD-15790,7,2152.352,1798,2,1,3,6,dormentes
349,JD-15895,32,7610.8640000000005,2075,1,5,5,11,não podemos perdê-los
350,JD-16015,11,385.43,1793,2,3,1,6,em risco
351,JD-16060,6,695.442,1981,1,1,1,3,dormentes
352,JD-16150,17,8828.0305,1722,4,4,5,13,clientes leais
353,JE-15475,13,1388.682,1874,2,3,2,7,em risco
354,JE-15610,20,7754.976,1729,4,5,5,14,clientes leais
355,JE-15715,22,8697.842999999999,1727,4,5,5,14,clientes leais
356,JE-15745,23,6760.8150000000005,1732,4,5,5,14,clientes leais
357,JE-16165,7,2697.248,1701,5,1,3,9,novos clientes
358,JF-15190,19,2279.5860000000002,1746,3,5,3,11,clientes leais
359,JF-15295,14,955.124,1906,1,4,1,6,em risco
360,JF-15355,16,1911.844,1786,2,4,3,9,em risco
361,JF-15415,14,2371.448,1683,5,4,3,12,campeões
362,JF-15490,15,1082.918,1802,2,4,2,8,em risco
363,JF-15565,16,4198.332,1735,3,4,4,11,clientes leais
364,JG-15115,7,2358.676,2439,1,1,3,5,dormentes
365,JG-15160,18,6366.392,1682,5,4,5,14,campeões
366,JG-15310,11,2240.58,1683,5,3,3,11,potenciais leais
367,JG-15805,9,1507.018,1904,2,2,2,6,dormentes
368,JH-15430,7,309.281,1686,5,1,1,7,novos clientes
369,JH-15820,8,528.91,1855,2,2,1,5,dormentes
370,JH-15910,9,959.477,1722,4,2,1,7,potenciais leais
371,JH-15985,14,7954.9980000000005,1710,4,4,5,13,clientes leais
372,JH-16180,5,2256.3940000000002,2085,1,1,3,5,dormentes
373,JJ-15445,6,709.178,2164,1,1,1,3,dormentes
374,JJ-15760,3,195.0,2434,1,1,1,3,dormentes
375,JK-15205,13,4427.142,1742,3,3,5,11,precisam de atenção
376,JK-15325,4,383.812,1968,1,1,1,3,dormentes
377,JK-15370,17,2709.632,1725,4,4,3,11,clientes leais
378,JK-15625,12,3760.028,1742,3,3,4,10,precisam de atenção
379,JK-15640,12,4760.434,1861,2,3,5,10,em risco
380,JK-15730,20,4867.2,1765,3,5,5,13,clientes leais
381,JK-16090,9,3747.668,1709,4,2,4,10,potenciais leais
382,JK-16120,17,2932.484,1798,2,4,4,10,em risco
383,JL-15130,12,1214.956,1689,5,3,2,10,potenciais leais
384,JL-15175,7,1571.523,1687,5,1,2,8,novos clientes
385,JL-15235,10,2203.7,1800,2,2,3,7,dormentes
386,JL-15505,17,3173.874,1730,4,4,4,12,clientes leais
387,JL-15835,34,9799.923,1702,5,5,5,15,campeões
388,JL-15850,11,2725.256,2295,1,3,3,7,em risco
389,JM-15250,19,3159.1220000000003,1718,4,5,4,13,clientes leais
390,JM-15265,13,1804.146,1718,4,3,3,10,potenciais leais
391,JM-15535,10,1733.443,1783,3,2,2,7,quase dormentes
392,JM-15580,7,303.948,1681,5,1,1,7,novos clientes
393,JM-15655,12,864.947,1689,5,3,1,9,potenciais leais
394,JM-15865,13,7625.076000000001,1790,2,3,5,10,em risco
395,JM-16195,19,2833.9260000000004,1738,3,5,4,12,clientes leais
396,JO-15145,13,3254.949,1738,3,3,4,10,precisam de atenção
397,JO-15280,11,1934.272,1773,3,3,3,9,precisam de atenção
398,JO-15550,11,1090.838,1896,2,3,2,7,em risco
399,JP-15460,15,1669.135,1718,4,4,2,10,clientes leais
400,JP-15520,16,3635.594,1689,5,4,4,13,campeões
401,JP-16135,13,1707.71,1783,3,3,2,8,precisam de atenção
402,JR-15670,3,1156.658,2274,1,1,2,4,dormentes
403,JR-15700,1,863.88,1749,3,1,1,5,quase dormentes
404,JR-16210,10,2201.686,1714,4,2,3,9,potenciais leais
405,JS-15595,8,1417.654,1800,2,2,2,6,dormentes
406,JS-15685,11,1131.0639999999999,1723,4,3,2,9,potenciais leais
407,JS-15880,9,3868.02,2215,1,2,4,7,dormentes
408,JS-15940,8,469.169,2144,1,2,1,4,dormentes
409,JS-16030,18,2516.494,1709,4,4,3,11,clientes leais
410,JW-15220,14,7721.714,1723,4,4,5,13,clientes leais
411,JW-15955,11,1244.086,1686,5,3,2,10,potenciais leais
412,JW-16075,7,1428.731,2142,1,1,2,4,dormentes
413,KA-16525,11,1519.506,1717,4,3,2,9,potenciais leais
414,KB-16240,10,3152.6150000000002,1685,5,2,4,11,potenciais leais
415,KB-16315,22,1569.464,1977,1,5,2,8,não podemos perdê-los
416,KB-16405,9,908.821,1798,2,2,1,5,dormentes
417,KB-16585,23,2744.742,1911,1,5,3,9,não podemos perdê-los
418,KB-16600,9,983.922,1682,5,2,2,9,potenciais leais
419,KC-16255,10,2120.954,2088,1,2,3,6,dormentes
420,KC-16540,5,3908.262,1778,3,1,4,8,quase dormentes
421,KC-16675,7,1146.05,1738,3,1,2,6,quase dormentes
422,KD-16270,16,8282.358,2165,1,4,5,10,em risco
423,KD-16345,10,1888.964,1722,4,2,3,9,potenciais leais
424,KD-16495,28,8181.256,1793,2,5,5,12,não podemos perdê-los
425,KD-16615,13,2243.5099999999998,1970,1,3,3,7,em risco
426,KE-16420,15,1686.7312,1707,5,4,2,11,campeões
427,KF-16285,18,10604.266,1778,3,4,5,12,clientes leais
428,KH-16330,18,3312.864,1721,4,4,4,12,clientes leais
429,KH-16360,14,3100.612,1682,5,4,4,13,campeões
430,KH-16510,23,5952.859,1703,5,5,5,15,campeões
431,KH-16630,17,3918.9660000000003,1739,3,4,4,11,clientes leais
432,KH-16690,15,5990.799,1683,5,4,5,14,campeões
433,KL-16555,22,5016.488,1697,5,5,5,15,campeões
434,KL-16645,29,14175.229000000001,1728,4,5,5,14,clientes leais
435,KM-16225,19,2260.958,1695,5,5,3,13,campeões
436,KM-16375,20,5620.186,1737,3,5,5,13,clientes leais
437,KM-16660,9,453.538,1696,5,2,1,8,potenciais leais
438,KM-16720,28,4909.472,1709,4,5,5,14,clientes leais
439,KN-16390,17,2617.272,1700,5,4,3,12,campeões
440,KN-16450,8,2171.962,1733,4,2,3,9,potenciais leais
441,KN-16705,15,2280.58,1779,3,4,3,10,clientes leais
442,KS-16300,4,88.472,1976,1,1,1,3,dormentes
443,KT-16465,14,3057.1,2072,1,4,4,9,em risco
444,KT-16480,13,4642.088400000001,1781,3,3,5,11,precisam de atenção
445,KW-16435,10,4416.5199999999995,1777,3,2,5,10,quase dormentes
446,KW-16570,5,449.096,2452,1,1,1,3,dormentes
447,LA-16780,26,8673.222,1835,2,5,5,12,não podemos perdê-los
448,LB-16735,3,50.188,1729,4,1,1,6,promissores
449,LB-16795,23,4704.304,1833,2,5,5,12,não podemos perdê-los
450,LC-16870,30,2580.7039999999997,1708,4,5,3,12,clientes leais
451,LC-16885,23,7663.126,1697,5,5,5,15,campeões
452,LC-16930,14,4492.946,1722,4,4,5,13,clientes leais
453,LC-16960,7,3246.626,2117,1,1,4,6,dormentes
454,LC-17050,9,2095.064,1735,3,2,3,8,quase dormentes
455,LC-17140,19,2633.582,1694,5,5,3,13,campeões
456,LD-16855,1,5.304,2233,1,1,1,3,dormentes
457,LD-17005,7,1961.934,2095,1,1,3,5,dormentes
458,LE-16810,9,1469.45,1702,5,2,2,9,potenciais leais
459,LF-17185,16,3930.5089999999996,1703,5,4,4,13,campeões
460,LH-16750,3,287.426,1832,2,1,1,4,dormentes
461,LH-16900,15,2295.332,1702,5,4,3,12,campeões
462,LH-17020,6,318.239,1920,1,1,1,3,dormentes
463,LH-17155,19,1739.689,2066,1,5,3,9,não podemos perdê-los
464,LL-16840,12,2741.2039999999997,1930,1,3,3,7,em risco
465,LM-17065,7,1346.774,2072,1,1,2,4,dormentes
466,LO-17170,9,644.35,1683,5,2,1,8,potenciais leais
467,LP-17080,9,756.606,1721,4,2,1,7,potenciais leais
468,LP-17095,15,3653.399,1690,5,4,4,13,campeões
469,LR-16915,16,5142.892,1707,5,4,5,14,campeões
470,LR-17035,12,1879.306,1813,2,3,3,8,em risco
471,LS-16945,14,2845.27,1859,2,4,4,10,em risco
472,LS-16975,22,2988.674,1701,5,5,4,14,campeões
473,LS-17200,14,1010.2560000000001,1777,3,4,2,9,clientes leais
474,LS-17230,6,368.88000000000005,2458,1,1,1,3,dormentes
475,LS-17245,12,1008.1360000000001,1715,4,3,2,9,potenciais leais
476,LT-16765,3,329.876,1707,5,1,1,7,novos clientes
477,LT-17110,14,2936.252,1715,4,4,4,12,clientes leais
478,LW-16825,15,2238.061,1769,3,4,3,10,clientes leais
479,LW-16990,11,3230.308,1714,4,3,4,11,potenciais leais
480,LW-17125,5,1259.04,1886,2,1,2,5,dormentes
481,LW-17215,15,5420.514,1702,5,4,5,14,campeões
482,MA-17560,34,4299.161,1745,3,5,5,13,clientes leais
483,MA-17995,12,2453.284,1867,2,3,3,8,em risco
484,MB-17305,19,1548.702,1729,4,5,2,11,clientes leais
485,MB-18085,10,1428.231,1725,4,2,2,8,potenciais leais
486,MC-17275,13,2725.982,1757,3,3,3,9,precisam de atenção
487,MC-17425,10,4432.138,2080,1,2,5,8,dormentes
488,MC-17575,11,1303.893,1708,4,3,2,9,potenciais leais
489,MC-17590,17,2426.067,1732,4,4,3,11,clientes leais
490,MC-17605,18,2258.192,1793,2,4,3,9,em risco
491,MC-17635,8,795.154,1870,2,2,1,5,dormentes
492,MC-17845,14,3805.714,1682,5,4,4,13,campeões
493,MC-18100,19,2218.98,1722,4,5,3,12,clientes leais
494,MC-18130,11,1581.9979999999998,2050,1,3,2,6,em risco
495,MD-17350,17,3766.382,1798,2,4,4,10,em risco
496,MD-17860,8,1204.91,1717,4,2,2,8,potenciais leais
497,ME-17320,22,10663.728000000001,1723,4,5,5,14,clientes leais
498,ME-17725,13,1908.4532,1709,4,3,3,10,potenciais leais
499,ME-18010,6,1256.944,1773,3,1,2,6,quase dormentes
500,MF-17665,8,937.039,2102,1,2,1,4,dormentes
501,MF-18250,12,1758.3,1688,5,3,3,11,potenciais leais
502,MG-17650,14,3785.276,1710,4,4,4,12,clientes leais
503,MG-17680,10,2350.188,1773,3,2,3,8,quase dormentes
504,MG-17695,7,1342.282,2236,1,1,2,4,dormentes
505,MG-17875,7,1242.8329999999999,1797,2,1,2,5,dormentes
506,MG-17890,13,776.384,1780,3,3,1,7,precisam de atenção
507,MG-18145,8,3061.543,1765,3,2,4,9,quase dormentes
508,MG-18205,2,16.739,1945,1,1,1,3,dormentes
509,MH-17290,13,2394.025,1800,2,3,3,8,em risco
510,MH-17440,9,400.016,2057,1,2,1,4,dormentes
511,MH-17455,11,2456.1820000000002,1766,3,3,3,9,precisam de atenção
512,MH-17620,6,1252.8,1836,2,1,2,5,dormentes
513,MH-17785,11,2203.7780000000002,1779,3,3,3,9,precisam de atenção
514,MH-18025,10,2984.948,1730,4,2,4,10,potenciais leais
515,MH-18115,22,5503.093,1686,5,5,5,15,campeões
516,MJ-17740,15,6320.746,1703,5,4,5,14,campeões
517,MK-17905,17,2302.368,1709,4,4,3,11,clientes leais
518,MK-18160,11,1031.602,1921,1,3,2,6,em risco
519,ML-17395,20,2722.843,1750,3,5,3,11,clientes leais
520,ML-17410,15,2921.5,1735,3,4,4,11,clientes leais
521,ML-17755,13,2071.9139999999998,1710,4,3,3,10,potenciais leais
522,ML-18040,4,742.082,1760,3,1,1,5,quase dormentes
523,ML-18265,3,162.232,1781,3,1,1,5,quase dormentes
524,MM-17260,6,1314.023,1849,2,1,2,5,dormentes
525,MM-17920,16,3794.0800000000004,1688,5,4,4,13,campeões
526,MM-18055,19,2749.881,1742,3,5,3,11,clientes leais
527,MM-18280,12,775.414,1766,3,3,1,7,precisam de atenção
528,MN-17935,10,2477.946,1715,4,2,3,9,potenciais leais
529,MO-17500,5,922.487,1753,3,1,1,5,quase dormentes
530,MO-17800,11,1687.0269999999998,1785,2,3,2,7,em risco
531,MO-17950,4,154.288,1861,2,1,1,4,dormentes
532,MP-17470,14,3206.132,2400,1,4,4,9,em risco
533,MP-17965,20,3983.6420000000003,1753,3,5,4,12,clientes leais
534,MP-18175,19,5087.92,1697,5,5,5,15,campeões
535,MR-17545,6,639.178,1806,2,1,1,4,dormentes
536,MS-17365,24,7443.6900000000005,1954,1,5,5,11,não podemos perdê-los
537,MS-17530,7,475.65599999999995,2115,1,1,1,3,dormentes
538,MS-17710,15,1613.402,2094,1,4,2,7,em risco
539,MS-17770,19,3144.678,1802,2,5,4,11,não podemos perdê-los
540,MS-17830,5,370.348,2133,1,1,1,3,dormentes
541,MS-17980,11,855.116,1707,5,3,1,9,potenciais leais
542,MT-17815,10,2890.139,1730,4,2,4,10,potenciais leais
543,MT-18070,11,1319.4498,1884,2,3,2,7,em risco
544,MV-17485,15,1560.05,1708,4,4,2,10,clientes leais
545,MV-18190,11,1734.574,1700,5,3,2,10,potenciais leais
546,MW-18220,14,5341.900000000001,1698,5,4,5,14,campeões
547,MW-18235,3,5253.876,1725,4,1,5,10,promissores
548,MY-17380,13,2254.285,1710,4,3,3,10,potenciais leais
549,MY-18295,21,4152.696,1752,3,5,4,12,clientes leais
550,MZ-17335,6,593.606,1711,4,1,1,6,promissores
551,MZ-17515,10,2564.906,1963,1,2,3,6,dormentes
552,NB-18580,2,273.87199999999996,2846,1,1,1,3,dormentes
553,NB-18655,17,1972.599,1700,5,4,3,12,campeões
554,NC-18340,17,2461.404,1905,2,4,3,9,em risco
555,NC-18415,14,2218.9900000000002,1722,4,4,3,11,clientes leais
556,NC-18535,15,8241.739,1687,5,4,5,14,campeões
557,NC-18625,9,1821.742,1885,2,2,3,7,dormentes
558,ND-18370,18,4326.139,1708,4,4,5,13,clientes leais
559,ND-18460,8,2893.455,1864,2,2,4,8,dormentes
560,NF-18385,14,8322.826,1760,3,4,5,12,clientes leais
561,NF-18475,4,377.16200000000003,2206,1,1,1,3,dormentes
562,NF-18595,12,2031.472,1795,2,3,3,8,em risco
563,NG-18355,16,1869.58,1729,4,4,3,11,clientes leais
564,NG-18430,9,1395.9379999999999,1729,4,2,2,8,potenciais leais
565,NH-18610,11,2673.29,1870,2,3,3,8,em risco
566,NK-18490,11,572.048,1751,3,3,1,7,precisam de atenção
567,NL-18310,10,1418.0900000000001,1739,3,2,2,7,quase dormentes
568,NM-18445,14,6459.344,1841,2,4,5,11,em risco
569,NM-18520,15,2161.979,1925,1,4,3,8,em risco
570,NP-18325,21,5529.62,1706,5,5,5,15,campeões
571,NP-18670,10,3908.402,1739,3,2,4,9,quase dormentes
572,NP-18685,7,1228.698,2087,1,1,2,4,dormentes
573,NP-18700,13,7903.1825,1819,2,3,5,10,em risco
574,NR-18550,13,2367.277,1891,2,3,3,8,em risco
575,NS-18505,15,2575.863,1687,5,4,3,12,campeões
576,NS-18640,26,2964.823,1855,2,5,4,11,não podemos perdê-los
577,NW-18400,22,7234.014,1853,2,5,5,12,não podemos perdê-los
578,NZ-18565,20,2488.31,1766,3,5,3,11,clientes leais
579,ON-18715,15,1567.52,2091,1,4,2,7,em risco
580,OT-18730,10,3818.624,1746,3,2,4,9,quase dormentes
581,PA-19060,7,729.408,1784,3,1,1,5,quase dormentes
582,PB-18805,10,740.356,1706,5,2,1,8,potenciais leais
583,PB-19105,5,688.324,1738,3,1,1,5,quase dormentes
584,PB-19150,11,1456.95,1778,3,3,2,8,precisam de atenção
585,PB-19210,2,132.738,2369,1,1,1,3,dormentes
586,PC-18745,5,1832.064,1683,5,1,3,9,novos clientes
587,PC-19000,3,1061.488,2563,1,1,2,4,dormentes
588,PF-19120,19,9062.864,2516,1,5,5,11,não podemos perdê-los
589,PF-19165,10,2770.0,1877,2,2,4,8,dormentes
590,PF-19225,10,2206.1279999999997,1795,2,2,3,7,dormentes
591,PG-18820,26,3086.907,1717,4,5,4,13,clientes leais
592,PG-18895,17,1987.164,1738,3,4,3,10,clientes leais
593,PH-18790,2,729.648,1751,3,1,1,5,quase dormentes
594,PJ-18835,13,1220.09,1720,4,3,2,9,potenciais leais
595,PJ-19015,10,1824.2340000000002,1815,2,2,3,7,dormentes
596,PK-18910,3,1441.152,2164,1,1,2,4,dormentes
597,PK-19075,25,8646.934,1690,5,5,5,15,campeões
598,PL-18925,8,239.481,1696,5,2,1,8,potenciais leais
599,PM-18940,4,1405.402,2067,1,1,2,4,dormentes
600,PM-19135,7,4115.662,1732,4,1,4,9,promissores
601,PN-18775,13,1467.152,1711,4,3,2,9,potenciais leais
602,PO-18850,22,7473.8282,1685,5,5,5,15,campeões
603,PO-18865,13,2493.214,1681,5,3,3,11,potenciais leais
604,PO-19180,18,4893.043,1841,2,4,5,11,em risco
605,PO-19195,10,1056.858,1767,3,2,2,7,quase dormentes
606,PP-18955,34,7252.608,1778,3,5,5,13,clientes leais
607,PR-18880,12,1840.178,1717,4,3,3,10,potenciais leais
608,PS-18760,21,2181.479,1788,2,5,3,10,não podemos perdê-los
609,PS-18970,13,1278.639,1750,3,3,2,8,precisam de atenção
610,PS-19045,13,6843.634,1917,1,3,5,9,em risco
611,PT-19090,7,160.572,1752,3,1,1,5,quase dormentes
612,PV-18985,13,2876.046,1770,3,3,4,10,precisam de atenção
613,PW-19030,13,3454.916,1727,4,3,4,11,potenciais leais
614,PW-19240,12,3922.4150000000004,2145,1,3,4,8,em risco
615,QJ-19255,13,6108.338,1706,5,3,5,13,potenciais leais
616,RA-19285,17,2617.906,1686,5,4,3,12,campeões
617,RA-19885,15,3832.314,1724,4,4,4,12,clientes leais
618,RA-19915,22,4793.543,1693,5,5,5,15,campeões
619,RA-19945,9,1686.9225,1742,3,2,2,7,quase dormentes
620,RB-19330,6,1008.1959999999999,1749,3,1,2,6,quase dormentes
621,RB-19360,18,15117.339,1777,3,4,5,12,clientes leais
622,RB-19435,16,2663.0860000000002,1700,5,4,3,12,campeões
623,RB-19465,23,4715.466,1690,5,5,5,15,campeões
624,RB-19570,9,528.546,1706,5,2,1,8,potenciais leais
625,RB-19645,7,221.084,2329,1,1,1,3,dormentes
626,RB-19705,7,2067.45,1735,3,1,3,7,quase dormentes
627,RB-19795,18,5633.316000000001,1713,4,4,5,13,clientes leais
628,RC-19825,10,966.409,2050,1,2,2,5,dormentes
629,RC-19960,11,885.752,1791,2,3,1,6,em risco
630,RD-19480,15,4272.93,1753,3,4,4,11,clientes leais
631,RD-19585,19,2912.8940000000002,1861,2,5,4,11,não podemos perdê-los
632,RD-19660,5,2786.632,1795,2,1,4,7,dormentes
633,RD-19720,20,1419.737,1702,5,5,2,12,campeões
634,RD-19810,16,1137.616,1695,5,4,2,11,campeões
635,RD-19900,21,3133.924,1795,2,5,4,11,não podemos perdê-los
636,RD-19930,10,970.9420000000001,1723,4,2,2,8,potenciais leais
637,RE-19405,1,48.36,2778,1,1,1,3,dormentes
638,RE-19450,9,876.696,1983,1,2,1,4,dormentes
639,RF-19345,16,3309.15,2071,1,4,4,9,em risco
640,RF-19735,14,2341.2960000000003,1770,3,4,3,10,clientes leais
641,RF-19840,11,945.222,1687,5,3,1,9,potenciais leais
642,RH-19495,8,3621.3759999999997,1713,4,2,4,10,potenciais leais
643,RH-19510,12,6979.18,2148,1,3,5,9,em risco
644,RH-19555,3,740.382,2200,1,1,1,3,dormentes
645,RH-19600,11,2085.7400000000002,2215,1,3,3,7,em risco
646,RK-19300,8,1460.192,1800,2,2,2,6,dormentes
647,RL-19615,24,6234.91,1802,2,5,5,12,não podemos perdê-los
648,RM-19375,9,1453.474,2026,1,2,2,5,dormentes
649,RM-19675,11,5979.0960000000005,1687,5,3,5,13,potenciais leais
650,RM-19750,2,98.35,1980,1,1,1,3,dormentes
651,RO-19780,12,3815.478,1716,4,3,4,11,potenciais leais
652,RP-19270,12,954.6452,2177,1,3,1,5,em risco
653,RP-19390,25,5153.084,1714,4,5,5,14,clientes leais
654,RP-19855,15,2170.716,1709,4,4,3,11,clientes leais
655,RR-19315,4,615.932,1700,5,1,1,7,novos clientes
656,RR-19525,10,3302.2619999999997,1851,2,2,4,8,dormentes
657,RS-19420,9,3221.29,1757,3,2,4,9,quase dormentes
658,RS-19765,14,4159.7699999999995,1717,4,4,4,12,clientes leais
659,RS-19870,3,22.328,1700,5,1,1,7,novos clientes
660,RW-19540,23,7397.401,1801,2,5,5,12,não podemos perdê-los
661,RW-19630,16,3279.746,1770,3,4,4,11,clientes leais
662,RW-19690,15,3495.646,1760,3,4,4,11,clientes leais
663,SA-20830,21,4767.3415,1744,3,5,5,13,clientes leais
664,SB-20170,7,1348.02,1882,2,1,2,5,dormentes
665,SB-20185,12,6410.996,1869,2,3,5,10,em risco
666,SB-20290,17,8057.891,1728,4,4,5,13,clientes leais
667,SC-20020,17,3362.9636,2462,1,4,4,9,em risco
668,SC-20050,15,4624.572,1721,4,4,5,13,clientes leais
669,SC-20095,22,14142.333999999999,2030,1,5,5,11,não podemos perdê-los
670,SC-20230,11,4371.9580000000005,1830,2,3,5,10,em risco
671,SC-20260,18,3729.7929999999997,1868,2,4,4,10,em risco
672,SC-20305,12,3979.065,1710,4,3,4,11,potenciais leais
673,SC-20380,20,5992.536,1711,4,5,5,14,clientes leais
674,SC-20440,10,1874.998,1717,4,2,3,9,potenciais leais
675,SC-20575,7,902.7280000000001,1773,3,1,1,5,quase dormentes
676,SC-20680,8,1254.64,1807,2,2,2,6,dormentes
677,SC-20695,14,2576.408,1770,3,4,3,10,clientes leais
678,SC-20725,26,5226.21,1868,2,5,5,12,não podemos perdê-los
679,SC-20770,21,4492.657,1722,4,5,5,14,clientes leais
680,SC-20800,5,279.25600000000003,1711,4,1,1,6,promissores
681,SC-20845,4,280.632,1812,2,1,1,4,dormentes
682,SD-20485,21,6121.114,1881,2,5,5,12,não podemos perdê-los
683,SE-20110,19,12209.438000000002,1690,5,5,5,15,campeões
684,SF-20065,9,763.5459999999999,1740,3,2,1,6,quase dormentes
685,SF-20200,15,3422.7859999999996,1740,3,4,4,11,clientes leais
686,SF-20965,17,3336.535,1729,4,4,4,12,clientes leais
687,SG-20080,11,3406.5809999999997,1689,5,3,4,12,potenciais leais
688,SG-20470,14,1884.798,1864,2,4,3,9,em risco
689,SG-20605,13,3124.832,1789,2,3,4,9,em risco
690,SG-20890,5,47.946,1907,1,1,1,3,dormentes
691,SH-19975,29,3406.8395,1710,4,5,4,13,clientes leais
692,SH-20395,15,2180.718,1704,5,4,3,12,campeões
693,SH-20635,2,2096.392,2446,1,1,3,5,dormentes
694,SJ-20125,24,3949.656,1776,3,5,4,12,clientes leais
695,SJ-20215,10,1341.036,1710,4,2,2,8,potenciais leais
696,SJ-20500,7,1318.776,1934,1,1,2,4,dormentes
697,SK-19990,5,883.409,1689,5,1,1,7,novos clientes
698,SL-20155,9,3053.012,1751,3,2,4,9,quase dormentes
699,SM-20005,6,244.49399999999997,2102,1,1,1,3,dormentes
700,SM-20320,15,25043.05,1760,3,4,5,12,clientes leais
701,SM-20905,6,1043.041,2287,1,1,2,4,dormentes
702,SM-20950,22,5563.392,1706,5,5,5,15,campeões
703,SN-20560,15,1860.418,1792,2,4,3,9,em risco
704,SN-20710,19,3127.9592,1760,3,5,4,12,clientes leais
705,SO-20335,15,2602.5755,1710,4,4,3,11,clientes leais
706,SP-20545,10,1306.086,2008,1,2,2,5,dormentes
707,SP-20620,24,5440.319,1728,4,5,5,14,clientes leais
708,SP-20650,15,1872.4360000000001,2067,1,4,3,8,em risco
709,SP-20860,24,4282.94,1760,3,5,5,13,clientes leais
710,SP-20920,14,3990.689,1751,3,4,4,11,clientes leais
711,SR-20425,9,3233.481,1689,5,2,4,11,potenciais leais
712,SR-20740,12,4345.8859999999995,1877,2,3,5,10,em risco
713,SS-20140,21,1324.028,1696,5,5,2,12,campeões
714,SS-20410,12,3056.8070000000002,1791,2,3,4,9,em risco
715,SS-20515,6,613.4,2172,1,1,1,3,dormentes
716,SS-20590,9,418.49,2113,1,2,1,4,dormentes
717,SS-20875,15,964.636,1801,2,4,2,8,em risco
718,ST-20530,12,433.34000000000003,1806,2,3,1,6,em risco
719,SU-20665,18,2595.364,1701,5,4,3,12,campeões
720,SV-20365,32,11470.949999999999,1782,3,5,5,13,clientes leais
721,SV-20785,25,4105.305,2001,1,5,4,10,não podemos perdê-los
722,SV-20815,6,1271.0900000000001,1757,3,1,2,6,quase dormentes
723,SV-20935,13,1903.491,1683,5,3,3,11,potenciais leais
724,SW-20245,10,1085.078,1762,3,2,2,7,quase dormentes
725,SW-20275,7,1966.65,1711,4,1,3,8,promissores
726,SW-20350,6,1019.044,1843,2,1,2,5,dormentes
727,SW-20455,9,2921.544,1843,2,2,4,8,dormentes
728,SW-20755,8,758.6959999999999,2215,1,2,1,4,dormentes
729,SZ-20035,20,3625.329,1716,4,5,4,13,clientes leais
730,TA-21385,10,14595.62,1750,3,2,5,10,quase dormentes
731,TB-21055,18,1467.881,1800,2,4,2,8,em risco
732,TB-21175,11,3589.296,1739,3,3,4,10,precisam de atenção
733,TB-21190,4,816.1740000000001,1730,4,1,1,6,promissores
734,TB-21250,19,1602.376,2030,1,5,2,8,não podemos perdê-los
735,TB-21280,11,2198.45,2264,1,3,3,7,em risco
736,TB-21355,13,834.328,1827,2,3,1,6,em risco
737,TB-21400,17,9133.99,1883,2,4,5,11,em risco
738,TB-21520,20,4737.486,1788,2,5,5,12,não podemos perdê-los
739,TB-21595,7,1387.559,1966,1,1,2,4,dormentes
740,TB-21625,15,2797.668,1711,4,4,4,12,clientes leais
741,TC-20980,12,19052.218,2080,1,3,5,9,em risco
742,TC-21145,4,1038.26,1787,2,1,2,5,dormentes
743,TC-21295,16,4266.812,1708,4,4,4,12,clientes leais
744,TC-21475,11,1244.976,1834,2,3,2,7,em risco
745,TC-21535,10,742.5580000000001,1685,5,2,1,8,potenciais leais
746,TD-20995,16,1434.5480000000002,1718,4,4,2,10,clientes leais
747,TG-21310,9,3058.372,2018,1,2,4,7,dormentes
748,TG-21640,10,2074.661,1795,2,2,3,7,dormentes
749,TH-21100,7,2422.824,2025,1,1,3,5,dormentes
750,TH-21115,9,2942.772,1739,3,2,4,9,quase dormentes
751,TH-21235,13,1022.201,1798,2,3,2,7,em risco
752,TH-21550,13,4234.0960000000005,1753,3,3,4,10,precisam de atenção
753,TM-21010,19,2955.2259999999997,1784,3,5,4,12,clientes leais
754,TM-21490,4,1094.6779999999999,1811,2,1,2,5,dormentes
755,TN-21040,12,3130.221,1771,3,3,4,10,precisam de atenção
756,TP-21130,16,4454.0560000000005,1689,5,4,5,14,campeões
757,TP-21415,10,5329.0048,1785,2,2,5,9,dormentes
758,TP-21565,10,1936.6399999999999,2031,1,2,3,6,dormentes
759,TR-21325,7,675.9419999999999,1874,2,1,1,4,dormentes
760,TS-21085,2,4.833,2038,1,1,1,3,dormentes
761,TS-21160,17,2163.6240000000003,2185,1,4,3,8,em risco
762,TS-21205,19,5371.09,1879,2,5,5,12,não podemos perdê-los
763,TS-21340,12,974.7819999999999,1907,1,3,2,6,em risco
764,TS-21370,15,11891.751,1717,4,4,5,13,clientes leais
765,TS-21430,7,2054.14,1853,2,1,3,6,dormentes
766,TS-21505,14,2243.274,1692,5,4,3,12,campeões
767,TS-21610,11,2820.424,1736,3,3,4,10,precisam de atenção
768,TS-21655,14,3368.094,1919,1,4,4,9,em risco
769,TT-21070,14,4915.602,1712,4,4,5,13,clientes leais
770,TT-21220,15,1427.0439999999999,1864,2,4,2,8,em risco
771,TT-21265,3,439.5,2087,1,1,1,3,dormentes
772,TT-21460,14,5364.808,1693,5,4,5,14,campeões
773,TW-21025,12,5278.826,1745,3,3,5,11,precisam de atenção
774,TZ-21580,9,1707.286,1716,4,2,2,8,potenciais leais
775,VB-21745,10,2005.596,1735,3,2,3,8,quase dormentes
776,VD-21670,16,6442.254,2262,1,4,5,10,em risco
777,VF-21715,11,847.944,1694,5,3,1,9,potenciais leais
778,VG-21790,8,846.01,1835,2,2,1,5,dormentes
779,VG-21805,6,427.372,1967,1,1,1,3,dormentes
780,VM-21685,12,2454.866,1735,3,3,3,9,precisam de atenção
781,VM-21835,8,380.69,1798,2,2,1,5,dormentes
782,VP-21730,5,993.9019999999999,1711,4,1,2,7,promissores
783,VP-21760,14,3360.526,1756,3,4,4,11,clientes leais
784,VS-21820,8,1055.981,1902,2,2,2,6,dormentes
785,VT-21700,9,1736.596,2681,1,2,2,5,dormentes
786,VW-21775,18,6134.0380000000005,1709,4,4,5,13,clientes leais
787,WB-21850,37,6160.102,1701,5,5,5,15,campeões
788,XP-21865,28,2374.658,1724,4,5,3,12,clientes leais
789,YC-21895,8,5454.35,1685,5,2,5,12,potenciais leais
790,YS-21880,12,6720.4439999999995,1690,5,3,5,13,potenciais leais
791,ZC-21910,31,8025.707,1735,3,5,5,13,clientes leais
792,ZD-21925,9,1493.944,1883,2,2,2,6,dormentes
